11111111111111
100000000C0001
1P010100110001
1001110C010001
1000C100011001
10000000000E01
11111111111111