11111111111111
100100000C0001
1P010000000001
1001110C010001
1000C000000001
10000000000E01
11111111111111
