1111111
10101E1
1P000C1
10C0111
1111111
