1111111
1010111
1P0E0C1
10C0111
1111111